







               F 158,142,255
C 0,98,133

      NO 					./maps/walls/wall1.xpm
SO ./maps/walls/wall2.xpm







WE     ./maps/walls/wall3.xpm  






EA./maps/walls/wall4.xpm


    11111111111111111111111111111
        1N00000000110000000000001
        1011000001110000000000001
        1001000000000000000000001
111111111011000001110000000000001
1000000000110000011111D1111111111
11110111111111011100010010011  
11110111111111011101010010001
110000000001 100011100000000011
11111111111111111111110111111
1000000000000000000000000011
10000000000000001101010000001														
11000001110101011111011100111
11110111 1110101 100011000001
11111111 1111111 111011111111
                1000000000001
                1111111110111
                         1