F 255,170,140
C 255,253,208
NO ./textures/WALLS/NORTH_WALL.xpm
SO ./textures/WALLS/SOUTH_WALL.xpm 
WE ./textures/WALLS/WEST_WALL.xpm  
EA ./textures/WALLS/EAST_WALL.xpm  

111111111111111111111111111111111111111
10001S100000000000000000000000000000001
100010D00100000000000000000011111111111
1000D0101D00000000000000000011111111111
100010100000000000000000000011111111111
100010100000000000000000000011111111111
100010100000000000000000000011111111111
100010100000000000000000000011111111111
100010100000000000100000000011111111111
100010100000000001 10000000001111111111
100010100000000000100000000011111111111
100010100000000000000000000011111111111
100010100000000000000000000011111111111
100010D00000011110000000000011111111111
11111111111111111111111111111