F 139,108,66

WE      ./textures/WALLS/WEST_WALL.xpm  
NO          ./textures/WALLS/NORTH_WALL.xpm
SO ./textures/WALLS/SOUTH_WALL.xpm 
EA ./textures/WALLS/EAST_WALL.xpm  

C 255,253,208

1111111
1N00011
1111111