F 139,108,66
C 255,253,208
NO ./textures/WALLS/NORTH_WALL.xpm
SO ./textures/WALLS/SOUTH_WALL.xpm 
WE ./textures/WALLS/WEST_WALL.xpm  
EA ./textures/WALLS/EAST_WALL.xpm  
    11111111111111111111111111111
        1000000000110000000000001
        1011000001110000000000001
        1001000000000000000000001
111111111011000001110000000000001
10000000001100000111110111D111111
11110111111111011100010010011  
11110111111111011101010010001
110000000001 100011100000000011
111111111111111D1111110111111
1000000000000000000000000011
1000N000000000001101010000001														
11000001110101011111011100111
11110111 1110101 100011000001
11111111 1111111 111011111111
                1000000000001
                1111111110111
                         1